{
	"fieldRefs":{
		"0":"https://raw.githubusercontent.com/BomberCatDHBW/bombercat/master/project/BomberCat/MapBlocks/Empty.jpg",
		"1":"https://raw.githubusercontent.com/BomberCatDHBW/bombercat/master/project/BomberCat/MapBlocks/Crate.jpg",
		"2":"https://raw.githubusercontent.com/BomberCatDHBW/bombercat/master/project/BomberCat/MapBlocks/Grassstone.jpg",
		"3":"https://raw.githubusercontent.com/BomberCatDHBW/bombercat/master/project/BomberCat/MapBlocks/Stone.jpg"
		
	},
	"spawns":{
		"0":{
			"x":1,
			"y":1
		},
		"1":{
			"x":1,
			"y":23
		},
		"2":{
			"x":23,
			"y":1
		},
		"3":{
			"x":23,
			"y":23
		}
	},
	"field":{
		 "0":[3,3,3,3,3,3,3,3,3,3,3,3,3,3,3,3,3,3,3,3,3,3,3,3,3],
		 "1":[3,0,0,1,1,1,1,1,1,1,1,1,3,1,1,1,1,1,1,1,1,1,0,0,3],
		 "2":[3,1,1,1,1,1,1,1,1,1,0,0,3,0,0,1,1,1,1,1,1,1,1,1,3],
		 "3":[3,1,1,1,1,1,1,1,1,1,0,0,3,0,0,1,1,1,1,1,1,1,1,1,3],
		 "4":[3,1,1,1,1,1,1,1,1,1,0,0,3,0,0,1,1,1,1,1,1,1,1,1,3],
		 "5":[3,1,1,1,1,1,1,1,1,1,0,0,3,0,0,1,1,1,1,1,1,1,1,1,3],
		 "6":[3,1,1,1,1,1,1,1,1,1,0,0,3,0,0,1,1,1,1,1,1,1,1,1,3],
		 "7":[3,1,1,1,1,1,1,1,1,1,0,0,3,0,0,1,1,1,1,1,1,1,1,1,3],
		 "8":[3,1,1,1,1,1,1,1,1,1,0,0,3,0,0,1,1,1,1,1,1,1,1,1,3],
		 "9":[3,1,1,1,1,1,1,1,1,1,0,0,3,0,0,1,1,1,1,1,1,1,1,1,3],
		"10":[3,1,1,1,1,1,1,1,1,1,0,0,3,0,0,1,1,1,1,1,1,1,1,1,3],
		"11":[3,1,1,1,1,1,1,1,1,1,0,0,3,0,0,1,1,1,1,1,1,1,1,1,3],
		"12":[3,3,3,3,3,1,1,3,3,3,3,3,3,3,3,3,3,3,1,1,3,3,3,3,3],
		"13":[3,1,1,1,1,1,1,1,1,1,0,0,3,0,0,1,1,1,1,1,1,1,1,1,3],
		"14":[3,1,1,1,1,1,1,1,1,1,0,0,3,0,0,1,1,1,1,1,1,1,1,1,3],
		"15":[3,1,1,1,1,1,1,1,1,1,0,0,3,0,0,1,1,1,1,1,1,1,1,1,3],
		"16":[3,1,1,1,1,1,1,1,1,1,0,0,3,0,0,1,1,1,1,1,1,1,1,1,3],
		"17":[3,1,1,1,1,1,1,1,1,1,0,0,3,0,0,1,1,1,1,1,1,1,1,1,3],
		"18":[3,1,1,1,1,1,1,1,1,1,0,0,3,0,0,1,1,1,1,1,1,1,1,1,3],
		"19":[3,1,1,1,1,1,1,1,1,1,0,0,3,0,0,1,1,1,1,1,1,1,1,1,3],
		"20":[3,1,1,1,1,1,1,1,1,1,0,0,3,0,0,1,1,1,1,1,1,1,1,1,3],
		"21":[3,1,1,1,1,1,1,1,1,1,0,0,3,0,0,1,1,1,1,1,1,1,1,1,3],
		"22":[3,1,1,1,1,1,1,1,1,1,0,0,3,0,0,1,1,1,1,1,1,1,1,1,3],
		"23":[3,0,0,1,1,1,1,1,1,1,1,1,3,1,1,1,1,1,1,1,1,1,0,0,3],
		"24":[3,3,3,3,3,3,3,3,3,3,3,3,3,3,3,3,3,3,3,3,3,3,3,3,3]
	},
	"fieldTypes":{
		"0":"Empty",
		"1":"Destructible",
		"2":"Indestructible",
		"3":"Indestructible"
	},
	"name":"TestMap",
	"width":25,
	"height":25
}
