{
	"fieldRefs":{
		"0":"https://raw.githubusercontent.com/BomberCatDHBW/bombercat/master/project/BomberCat/MapBlocks/Empty.jpg",
		"1":"https://raw.githubusercontent.com/BomberCatDHBW/bombercat/master/project/BomberCat/MapBlocks/Destructible.jpg",
		"2":"https://raw.githubusercontent.com/BomberCatDHBW/bombercat/master/project/BomberCat/MapBlocks/Indestructible.jpg"
	},
	"spawns":{
		"0":{
			"x":0,
			"y":0
		},
		"1":{
			"x":0,
			"y":25
		},
		"2":{
			"x":25,
			"y":0
		},
		"3":{
			"x":25,
			"y":25
		}
	},
	"field":{
		 "0":[2,2,2,2,2,2,2,2,2,2,2,2,2,2,2,2,2,2,2,2,2,2,2,2,2],
		 "1":[2,0,0,1,1,1,1,1,1,1,1,1,1,1,1,1,1,1,1,1,1,1,0,0,2],
		 "2":[2,0,2,1,2,1,2,1,2,1,2,1,1,1,2,1,2,1,2,1,2,1,2,0,2],
		 "3":[2,1,1,1,1,1,1,1,1,1,1,1,2,1,1,1,1,1,1,1,1,1,1,1,2],
		 "4":[2,1,2,1,2,1,2,1,2,1,2,1,2,1,2,1,2,1,2,1,2,1,2,1,2],
		 "5":[2,1,1,1,1,1,1,1,1,1,1,1,2,1,1,1,1,1,1,1,1,1,1,1,2],
		 "6":[2,1,2,1,2,1,2,1,2,1,2,1,2,1,2,1,2,1,2,1,2,1,2,1,2],
		 "7":[2,1,1,1,1,1,1,1,1,1,1,1,2,1,1,1,1,1,1,1,1,1,1,1,2],
		 "8":[2,1,2,1,2,1,2,1,2,1,2,1,2,1,2,1,2,1,2,1,2,1,2,1,2],
		 "9":[2,1,1,1,1,1,1,1,1,1,1,1,2,1,1,1,1,1,1,1,1,1,1,1,2],
		"10":[2,1,2,1,2,1,2,1,2,1,2,0,2,0,2,1,2,1,2,1,2,1,2,1,2],
		"11":[2,1,1,1,1,1,1,1,1,1,0,0,2,0,0,1,1,1,1,1,1,1,1,1,2],
		"12":[2,1,1,2,2,2,2,2,2,2,2,2,2,2,2,2,2,2,2,2,2,2,1,1,2],
		"13":[2,1,1,1,1,1,1,1,1,1,0,0,2,0,0,1,1,1,1,1,1,1,1,1,2],
		"14":[2,1,2,1,2,1,2,1,2,1,2,0,2,0,2,1,2,1,2,1,2,1,2,1,2],
		"15":[2,1,1,1,1,1,1,1,1,1,1,1,2,1,1,1,1,1,1,1,1,1,1,1,2],
		"16":[2,1,2,1,2,1,2,1,2,1,2,1,2,1,2,1,2,1,2,1,2,1,2,1,2],
		"17":[2,1,1,1,1,1,1,1,1,1,1,1,2,1,1,1,1,1,1,1,1,1,1,1,2],
		"18":[2,1,2,1,2,1,2,1,2,1,2,1,2,1,2,1,2,1,2,1,2,1,2,1,2],
		"19":[2,1,1,1,1,1,1,1,1,1,1,1,2,1,1,1,1,1,1,1,1,1,1,1,2],
		"20":[2,1,2,1,2,1,2,1,2,1,2,1,2,1,2,1,2,1,2,1,2,1,2,1,2],
		"21":[2,1,1,1,1,1,1,1,1,1,1,1,2,1,1,1,1,1,1,1,1,1,1,1,2],
		"22":[2,0,2,1,2,1,2,1,2,1,2,1,1,1,2,1,2,1,2,1,2,1,2,0,2],
		"23":[2,0,0,1,1,1,1,1,1,1,1,1,1,1,1,1,1,1,1,1,1,1,0,0,2],
		"24":[2,2,2,2,2,2,2,2,2,2,2,2,2,2,2,2,2,2,2,2,2,2,2,2,2]
	},
	"fieldTypes":{
		"0":"Empty",
		"1":"Destructible",
		"2":"Indestructible"
	},
	"name":"TestMap",
	"width":25,
	"height":25
}
